//MAP CONVERTED BY dmm2tgm.py THIS HEADER COMMENT PREVENTS RECONVERSION, DO NOT REMOVE
"a" = (
/turf/closed/wall/mineral/titanium,
/area/shuttle/supply)
"b" = (
/turf/open/floor/deadspace/heavy,
/area/shuttle/supply)
"c" = (
/obj/machinery/light/directional/north,
/obj/effect/turf_decal/stripes/line{
	dir = 1
	},
/turf/open/floor/deadspace/heavy,
/area/shuttle/supply)
"d" = (
/obj/machinery/door/unpowered/shuttle,
/turf/open/floor/deadspace/mono,
/area/shuttle/supply)
"e" = (
/obj/effect/turf_decal/stripes/line{
	dir = 8
	},
/turf/open/floor/deadspace/heavy,
/area/shuttle/supply)
"g" = (
/obj/machinery/light/floor/has_bulb,
/turf/open/floor/deadspace/heavy,
/area/shuttle/supply)
"h" = (
/obj/effect/decal/cleanable/dirt,
/obj/effect/turf_decal/delivery,
/turf/open/floor/deadspace/heavy,
/area/shuttle/supply)
"i" = (
/obj/structure/shuttle/engine/propulsion,
/turf/open/floor/plating,
/area/shuttle/supply)
"j" = (
/obj/effect/turf_decal/delivery,
/turf/open/floor/deadspace/heavy,
/area/shuttle/supply)
"k" = (
/obj/structure/window/reinforced{
	dir = 1
	},
/obj/structure/shuttle/engine/heater,
/obj/effect/decal/cleanable/dirt,
/obj/effect/turf_decal/stripes/line,
/turf/open/floor/plating/airless,
/area/shuttle/supply)
"l" = (
/obj/structure/window/reinforced{
	dir = 1
	},
/obj/structure/shuttle/engine/heater,
/obj/effect/turf_decal/stripes/line,
/turf/open/floor/plating/airless,
/area/shuttle/supply)
"q" = (
/obj/machinery/door/unpowered/shuttle,
/obj/docking_port/mobile/supply{
	dir = 4;
	width = 10;
	dwidth = 4
	},
/turf/open/floor/deadspace/mono,
/area/shuttle/supply)
"s" = (
/obj/effect/turf_decal/stripes/line{
	dir = 5
	},
/turf/open/floor/deadspace/heavy,
/area/shuttle/supply)
"C" = (
/obj/effect/turf_decal/stripes/line{
	dir = 9
	},
/turf/open/floor/deadspace/heavy,
/area/shuttle/supply)
"H" = (
/obj/effect/turf_decal/stripes/line{
	dir = 4
	},
/turf/open/floor/deadspace/heavy,
/area/shuttle/supply)
"M" = (
/obj/effect/turf_decal/stripes/line{
	dir = 10
	},
/turf/open/floor/deadspace/heavy,
/area/shuttle/supply)
"Q" = (
/obj/effect/turf_decal/stripes/line,
/turf/open/floor/deadspace/heavy,
/area/shuttle/supply)
"S" = (
/obj/effect/turf_decal/stripes/line{
	dir = 1
	},
/turf/open/floor/deadspace/heavy,
/area/shuttle/supply)
"T" = (
/turf/template_noop,
/area/template_noop)
"Y" = (
/obj/effect/turf_decal/stripes/line{
	dir = 6
	},
/turf/open/floor/deadspace/heavy,
/area/shuttle/supply)

(1,1,1) = {"
a
a
a
d
q
d
d
a
a
T
"}
(2,1,1) = {"
a
C
e
e
e
e
M
a
a
i
"}
(3,1,1) = {"
a
c
b
b
b
b
Q
h
l
i
"}
(4,1,1) = {"
a
S
b
b
g
b
Q
h
k
i
"}
(5,1,1) = {"
a
c
b
b
b
b
Q
j
k
i
"}
(6,1,1) = {"
a
s
H
H
H
H
Y
a
a
i
"}
(7,1,1) = {"
a
a
a
d
d
d
d
a
a
T
"}
