//MAP CONVERTED BY dmm2tgm.py THIS HEADER COMMENT PREVENTS RECONVERSION, DO NOT REMOVE
"a" = (
/turf/closed/wall/mineral/titanium,
/area/shuttle/mining)
"b" = (
/obj/effect/spawner/structure/window/reinforced/shuttle,
/obj/machinery/door/firedoor,
/turf/open/floor/iron/smooth_large,
/area/shuttle/mining)
"c" = (
/obj/structure/table/reinforced,
/turf/open/floor/deadspace/random/rectangles,
/area/shuttle/mining)
"d" = (
/turf/open/floor/deadspace/random/rectangles,
/area/shuttle/mining)
"e" = (
/obj/structure/table/reinforced,
/obj/machinery/light/directional/east,
/turf/open/floor/deadspace/random/rectangles,
/area/shuttle/mining)
"f" = (
/obj/structure/chair/comfy/shuttle{
	dir = 1
	},
/turf/open/floor/deadspace/random/rectangles,
/area/shuttle/mining)
"g" = (
/obj/machinery/door/airlock/mining{
	name = "Mining Tram"
	},
/obj/machinery/door/firedoor,
/obj/docking_port/mobile{
	height = 8;
	id = "mining";
	name = "mining shuttle";
	port_direction = 4;
	width = 5;
	dheight = 4
	},
/turf/open/floor/iron/smooth_large,
/area/shuttle/mining)
"h" = (
/turf/open/floor/deadspace/grater,
/area/shuttle/mining)
"i" = (
/obj/structure/chair/comfy/shuttle{
	dir = 8
	},
/turf/open/floor/deadspace/random/rectangles,
/area/shuttle/mining)
"j" = (
/obj/effect/turf_decal/box,
/turf/open/floor/deadspace/random/rectangles,
/area/shuttle/mining)
"k" = (
/obj/structure/chair/comfy/shuttle{
	dir = 8
	},
/obj/machinery/light/directional/east,
/turf/open/floor/deadspace/random/rectangles,
/area/shuttle/mining)
"l" = (
/obj/structure/shuttle/engine/propulsion,
/turf/open/floor/plating,
/area/shuttle/mining)
"q" = (
/obj/structure/shuttle/engine/heater,
/obj/structure/window/reinforced{
	dir = 1;
	layer = 2.9
	},
/obj/structure/window/reinforced{
	dir = 8
	},
/obj/structure/window/reinforced{
	dir = 4
	},
/turf/open/floor/plating,
/area/shuttle/mining)
"W" = (
/obj/machinery/computer/shuttle/mining,
/turf/open/floor/deadspace/random/rectangles,
/area/shuttle/mining)

(1,1,1) = {"
a
a
a
g
a
a
a
a
"}
(2,1,1) = {"
b
c
d
h
j
j
j
a
"}
(3,1,1) = {"
b
W
f
h
h
h
q
l
"}
(4,1,1) = {"
b
e
d
i
i
k
j
a
"}
(5,1,1) = {"
a
a
a
b
a
a
a
a
"}
