//MAP CONVERTED BY dmm2tgm.py THIS HEADER COMMENT PREVENTS RECONVERSION, DO NOT REMOVE
"a" = (
/turf/closed/wall/mineral/titanium,
/area/shuttle/escape)
"b" = (
/obj/machinery/door/airlock/external,
/obj/structure/fans/tiny/invisible,
/turf/open/floor/deadspace/mono,
/area/shuttle/escape)
"c" = (
/obj/effect/spawner/random/trash/food_packaging,
/turf/open/floor/mineral/plastitanium/red/brig,
/area/shuttle/escape/brig)
"d" = (
/obj/effect/spawner/random/trash/graffiti,
/turf/open/floor/mineral/plastitanium/red/brig,
/area/shuttle/escape/brig)
"e" = (
/obj/effect/turf_decal/delivery,
/obj/effect/spawner/random/trash/garbage,
/obj/machinery/light/warm/directional/west,
/turf/open/floor/deadspace/grater,
/area/shuttle/escape)
"f" = (
/obj/effect/turf_decal/delivery,
/obj/effect/spawner/random/trash/garbage,
/turf/open/floor/deadspace/grater,
/area/shuttle/escape)
"g" = (
/obj/effect/turf_decal/caution,
/obj/effect/spawner/random/trash/graffiti,
/turf/open/floor/deadspace/grater,
/area/shuttle/escape)
"h" = (
/obj/effect/turf_decal/delivery,
/obj/effect/spawner/random/trash/garbage,
/obj/effect/spawner/random/trash/box,
/turf/open/floor/deadspace/grater,
/area/shuttle/escape)
"i" = (
/obj/effect/turf_decal/delivery,
/obj/effect/spawner/random/trash/garbage,
/obj/machinery/light/warm/directional/east,
/turf/open/floor/deadspace/grater,
/area/shuttle/escape)
"j" = (
/turf/open/floor/mineral/plastitanium/red/brig,
/area/shuttle/escape/brig)
"k" = (
/obj/effect/spawner/structure/window/reinforced/shuttle,
/turf/open/floor/deadspace/mono,
/area/shuttle/escape)
"l" = (
/obj/effect/turf_decal/ported,
/obj/effect/spawner/random/trash/garbage,
/turf/open/floor/deadspace/grater,
/area/shuttle/escape)
"m" = (
/obj/effect/spawner/random/trash/garbage,
/obj/effect/spawner/random/structure/barricade,
/turf/open/floor/deadspace/grater,
/area/shuttle/escape)
"n" = (
/obj/effect/turf_decal/delivery,
/obj/effect/spawner/random/trash/garbage,
/obj/effect/spawner/random/trash/garbage,
/turf/open/floor/deadspace/grater,
/area/shuttle/escape)
"o" = (
/obj/effect/spawner/structure/window/reinforced/shuttle,
/obj/structure/fans/tiny/invisible,
/turf/open/floor/deadspace/mono,
/area/shuttle/escape)
"p" = (
/obj/effect/spawner/random/trash/graffiti,
/obj/machinery/light/warm/directional/west,
/obj/structure/chair/office{
	dir = 4
	},
/turf/open/floor/mineral/plastitanium/red/brig,
/area/shuttle/escape/brig)
"q" = (
/obj/effect/turf_decal/ported,
/obj/effect/spawner/random/trash/garbage,
/obj/effect/spawner/random/trash/food_packaging,
/turf/open/floor/deadspace/grater,
/area/shuttle/escape)
"r" = (
/obj/effect/spawner/random/trash/garbage,
/turf/open/floor/deadspace/grater,
/area/shuttle/escape)
"s" = (
/obj/effect/turf_decal/delivery,
/obj/effect/spawner/random/trash/garbage,
/obj/effect/spawner/random/trash/garbage,
/obj/effect/spawner/random/trash/box,
/turf/open/floor/deadspace/grater,
/area/shuttle/escape)
"t" = (
/obj/machinery/door/airlock/hatch,
/turf/open/floor/deadspace/mono,
/area/shuttle/escape)
"u" = (
/obj/effect/turf_decal/delivery,
/obj/effect/spawner/random/trash/graffiti,
/turf/open/floor/deadspace/grater,
/area/shuttle/escape)
"v" = (
/obj/effect/turf_decal/ported,
/obj/effect/spawner/random/trash/garbage,
/obj/effect/spawner/random/trash/garbage,
/obj/effect/spawner/random/trash/garbage,
/turf/open/floor/deadspace/grater,
/area/shuttle/escape)
"w" = (
/obj/effect/turf_decal/caution{
	icon_state = "caution";
	dir = 1
	},
/turf/open/floor/deadspace/grater,
/area/shuttle/escape)
"x" = (
/obj/effect/turf_decal/delivery,
/obj/effect/spawner/random/trash/garbage,
/obj/effect/spawner/random/trash/garbage,
/obj/machinery/light/warm/directional/east,
/turf/open/floor/deadspace/grater,
/area/shuttle/escape)
"V" = (
/obj/machinery/door/airlock/external,
/obj/structure/fans/tiny/invisible,
/obj/docking_port/mobile/emergency{
	name = "Mara 17 emergency shuttle";
	dir = 1
	},
/turf/open/floor/deadspace/mono,
/area/shuttle/escape)

(1,1,1) = {"
a
a
a
a
a
a
a
"}
(2,1,1) = {"
a
c
j
p
j
c
a
"}
(3,1,1) = {"
a
d
j
j
c
j
a
"}
(4,1,1) = {"
a
a
k
k
t
a
a
"}
(5,1,1) = {"
a
e
f
f
u
e
a
"}
(6,1,1) = {"
a
f
l
q
l
f
a
"}
(7,1,1) = {"
b
g
m
r
m
w
V
"}
(8,1,1) = {"
a
h
l
l
v
f
a
"}
(9,1,1) = {"
a
i
n
s
n
x
a
"}
(10,1,1) = {"
a
a
o
o
o
a
a
"}
