//MAP CONVERTED BY dmm2tgm.py THIS HEADER COMMENT PREVENTS RECONVERSION, DO NOT REMOVE
"a" = (
/turf/open/floor/deadspace/random/maint_center,
/area/shuttle/escape/backup)
"e" = (
/turf/open/space/openspace,
/area/template_noop)
"h" = (
/obj/machinery/computer/communications{
	dir = 8
	},
/turf/open/floor/deadspace/random/slides,
/area/shuttle/escape/backup)
"j" = (
/obj/structure/table,
/obj/item/storage/medkit/regular{
	pixel_x = 2;
	pixel_y = 3
	},
/obj/item/storage/medkit/fire,
/turf/open/floor/deadspace/random/maint_right,
/area/shuttle/escape/backup)
"k" = (
/turf/closed/wall/mineral/titanium,
/area/shuttle/escape/backup)
"m" = (
/obj/docking_port/mobile/emergency/backup{
	id = "aegis2"
	},
/turf/closed/wall/mineral/titanium,
/area/shuttle/escape/backup)
"n" = (
/obj/machinery/door/airlock/public/glass{
	name = "Emergency Shuttle Cockpit"
	},
/turf/open/floor/deadspace/random/maint_center,
/area/shuttle/escape/backup)
"o" = (
/obj/structure/window/reinforced{
	dir = 4
	},
/obj/structure/chair/comfy/shuttle{
	dir = 8
	},
/turf/open/floor/deadspace/random/maint_center,
/area/shuttle/escape/backup)
"p" = (
/obj/structure/extinguisher_cabinet/directional/east,
/turf/open/floor/deadspace/random/slides,
/area/shuttle/escape/backup)
"q" = (
/obj/machinery/light/directional/south,
/obj/structure/chair/comfy/shuttle{
	dir = 8
	},
/turf/open/floor/deadspace/random/slides,
/area/shuttle/escape/backup)
"r" = (
/obj/machinery/light/directional/south,
/obj/structure/chair/comfy/shuttle{
	dir = 4
	},
/turf/open/floor/deadspace/random/slides{
	dir = 1
	},
/area/shuttle/escape/backup)
"s" = (
/obj/structure/shuttle/engine/heater{
	dir = 1
	},
/obj/structure/window/reinforced,
/turf/open/space/basic,
/area/shuttle/escape/backup)
"t" = (
/obj/machinery/computer/crew{
	dir = 4
	},
/turf/open/floor/deadspace/random/slides{
	dir = 1
	},
/area/shuttle/escape/backup)
"v" = (
/obj/machinery/computer/emergency_shuttle{
	dir = 1
	},
/turf/open/floor/deadspace/random/maint_center,
/area/shuttle/escape/backup)
"w" = (
/turf/closed/wall/mineral/titanium,
/turf/open/space/basic,
/area/shuttle/escape/backup)
"B" = (
/obj/structure/chair/comfy/shuttle,
/obj/machinery/button/door/directional/west{
	pixel_x = -30;
	pixel_y = 3;
	name = "Shuttle Lock Down";
	id = "evac_1"
	},
/turf/open/floor/deadspace/random/maint_center,
/area/shuttle/escape/backup)
"C" = (
/obj/structure/shuttle/engine/propulsion{
	dir = 1
	},
/turf/open/space/basic,
/area/shuttle/escape/backup)
"D" = (
/obj/structure/chair/comfy/shuttle{
	dir = 8
	},
/turf/open/floor/deadspace/random/slides,
/area/shuttle/escape/backup)
"F" = (
/obj/machinery/light/directional/west,
/obj/machinery/computer/atmos_alert{
	dir = 4
	},
/turf/open/floor/deadspace/random/slides{
	dir = 1
	},
/area/shuttle/escape/backup)
"G" = (
/obj/machinery/status_display/evac/directional/south,
/turf/open/floor/deadspace/random/maint_center,
/area/shuttle/escape/backup)
"H" = (
/obj/machinery/light/directional/west,
/obj/structure/chair/comfy/shuttle{
	dir = 4
	},
/turf/open/floor/deadspace/random/slides{
	dir = 1
	},
/area/shuttle/escape/backup)
"I" = (
/obj/machinery/light/directional/east,
/obj/machinery/computer/security{
	dir = 8
	},
/turf/open/floor/deadspace/random/slides,
/area/shuttle/escape/backup)
"J" = (
/obj/effect/spawner/structure/window/reinforced/shuttle,
/obj/machinery/door/poddoor/preopen{
	id = "evac_1"
	},
/turf/open/floor/plating,
/area/shuttle/escape/backup)
"M" = (
/obj/structure/chair/comfy/shuttle{
	dir = 4
	},
/turf/open/floor/deadspace/random/slides{
	dir = 1
	},
/area/shuttle/escape/backup)
"N" = (
/obj/machinery/door/airlock/shuttle,
/obj/machinery/door/poddoor/preopen{
	id = "evac_1"
	},
/turf/open/floor/deadspace/mono,
/area/shuttle/escape/backup)
"O" = (
/obj/machinery/light/directional/east,
/obj/structure/chair/comfy/shuttle{
	dir = 8
	},
/turf/open/floor/deadspace/random/slides,
/area/shuttle/escape/backup)
"Q" = (
/obj/structure/chair/comfy/shuttle{
	dir = 8
	},
/turf/open/floor/deadspace/random/maint_left,
/area/shuttle/escape/backup)
"R" = (
/turf/open/floor/deadspace/random/slides{
	dir = 1
	},
/area/shuttle/escape/backup)
"T" = (
/turf/open/floor/deadspace/random/slides,
/area/shuttle/escape/backup)
"V" = (
/obj/structure/window/reinforced{
	dir = 8
	},
/obj/structure/chair/comfy/shuttle{
	dir = 4
	},
/turf/open/floor/deadspace/random/maint_center,
/area/shuttle/escape/backup)
"X" = (
/obj/structure/chair/comfy/shuttle{
	dir = 4
	},
/turf/open/floor/deadspace/random/maint_right,
/area/shuttle/escape/backup)
"Y" = (
/obj/structure/table,
/turf/open/floor/deadspace/random/maint_left,
/area/shuttle/escape/backup)
"Z" = (
/turf/open/space/basic,
/turf/closed/wall/mineral/titanium,
/area/shuttle/escape/backup)

(1,1,1) = {"
k
k
k
N
N
k
m
k
k
k
k
k
e
"}
(2,1,1) = {"
C
s
H
R
R
R
M
r
k
t
F
k
k
"}
(3,1,1) = {"
C
s
a
a
a
a
a
a
Z
Q
Q
Y
J
"}
(4,1,1) = {"
C
s
a
o
o
o
o
a
n
a
a
B
J
"}
(5,1,1) = {"
C
s
a
V
V
V
V
G
w
a
a
v
J
"}
(6,1,1) = {"
C
s
a
a
a
a
a
a
k
X
X
j
J
"}
(7,1,1) = {"
C
s
O
T
T
p
D
q
k
h
I
k
k
"}
(8,1,1) = {"
k
k
k
N
N
k
k
k
k
k
k
k
e
"}
